111111111111111111111111111111111111111111111111111111111111
1000000000000S00000000C000100000000000010C000101101000000001
1000000000000S0000000000000100000000000100000101100000000001
1000000000000S00000000C00000100000C00000100001C11000000C0001
100000000000000000C0000000C0010000000001000001000000000C0001
1000P000S0000S000000000000S0001000000000000000000000000E0001
1000000000000S00000000C000C0000S0C000000000000011010000S0001
1000000000000CS00000000000C000000C000000000001011010000C0001
1000000000000S00000000C0000000000S00000000000100S010000S0001
100000S00000000000000000000000000C1000010000010C001000010001
1C00000000000S00000000000000000000010001000001011010000S0001
111111111111111111111111111111111111111111111111111111111111