1111111111111
10C1000SSS0C1
100001000C001
1P0C01E000001
1111111111111
11S11S1SSSS11
11S11S1111S11
11SSSS1SSSS11
11111S1S11111
11111S1SSSS11
1111111111111
1111111111111