111111111111111111111111111111111111111111
1P0000000000000000000000000000000000000001
100000000000000000000000000000000000000001
10000000CC0CC00000CCCC00000000011011000001
10000000CC0CC0000C00CC00000000100100100001
10000000CCCCC000000CC000000000100000100001
10000000CCCCC00000CC0000000000010001000001
10000000000CC0000CCC0000000000001010000001
10000000000CC000CCCCCC00000000000100000001
100000000000000000000000000000000000000001
1000000000000000000000000000000000000000E1
111111111111111111111111111111111111111111