1111111111111
10010000000C0
1000111110001
1P0011E000001
1111111111111
