1111111111111
10010000000C1
1000111110001
0P0011E000001
1111111111111
